1001 1001 1001 1001 1001 1001 1001 1001 1001 1001 1001 1001 1001 1001 1001 1001 1001 1001 1001 1001 1001 1001 1001
1001 0001 0001 0001 0001 0001 1000 1000 1000 1000 1000 1000 0001 1000 0001 0001 0001 0001 0001 0001 1000 0001 1001
1001 0001 1000 1000 1000 0001 1000 0001 1000 0001 0001 0001 0001 1000 0001 1000 1000 1000 1000 0001 0001 0001 1001
1001 1000 1000 0001 1000 0001 1000 0001 0001 0001 0001 1000 0001 1000 0001 0001 0001 0001 1000 0001 1000 1000 1001
1001 0001 1000 0001 1000 0001 0001 0001 0001 1000 1000 1000 0001 1000 1000 1000 0001 1000 1000 0001 0001 1000 1001
1001 0001 1000 0001 1000 1000 1000 1000 1000 1000 0001 0001 0001 0001 0001 0001 0001 0001 1000 1000 0001 0001 1001
1001 0001 1000 0001 0001 0001 1000 0001 0001 1000 0001 1000 1000 1000 1000 1000 1000 1000 1000 0001 0001 1000 1001
1001 0001 0001 0001 1000 0001 0001 0001 0001 1000 0001 0001 0001 0001 0001 0001 0001 0001 0001 0001 0001 0001 1001
1001 0001 1000 0001 1000 1000 1000 0001 1000 1000 0001 0001 0001 1000 1000 1000 1000 1000 1000 1000 0001 1000 1001
1001 0001 1000 0001 1000 0001 0001 0001 0001 1000 0001 0001 0001 0001 0001 0001 0001 1000 0001 1000 0001 1000 1001
1001 0001 1000 0001 1000 0001 0001 1000 0001 1000 0001 1000 0001 1000 1000 1000 0001 1000 0001 1000 0001 1000 1001
1001 0001 1000 0001 1000 0001 1000 1000 0001 1000 0001 0001 0001 1000 0001 1000 0001 1000 0001 1000 0001 1000 1001
1001 0001 1000 0001 1000 0001 0001 0001 0001 0001 0001 0001 0001 1000 0001 0001 0001 1000 0001 0001 0001 0001 1001
1001 0001 1000 1000 1000 1000 1000 1000 0001 0001 1000 0001 0001 1000 1000 1000 1000 1000 1000 1000 1000 0001 1001
1001 0001 1000 0001 0001 0001 0001 1000 1000 0001 1000 1000 0001 1000 0001 0001 0001 1000 0001 0001 0001 0001 1001
1001 0001 0001 0001 1000 1000 0001 0001 0001 0001 0001 0001 0001 0001 0001 1000 0001 0001 0001 1000 0001 0001 1001
1001 1001 1001 1001 1001 1001 1001 1001 1001 1001 1001 1001 1001 1001 1001 1001 1001 1001 1001 1001 1001 1001 1001
